AAAAAAAAAAAAAAAV
BBBBBTBBBBBBTBBC
BBBBBBBBBBBBBBBC
BBBBBBBBBBBBBBBC
BBBBBBBBBBBBBBBC
BBBBBBBBBBBBBBBC
BBBBBBBBBBBBBBBC
BBBBBBBBBBBBBBBC
BBBBBBBBBBBBBBBC